name: Tutorial
layout:
##########
#  $     #
#  2 + a #
#  3 * b #
##########

name: level2
layout:
###########
##       ##
#  2      #
# +     * #
#       1 #
## 3      #
###      ##
###     ###
###    ####
#####  ####
#####I$####
###########
