name: Tutorial
layout:
##########
#  $     #
#  2 + a #
#  3 * b #
##########
