{
  "metadata": {
    "name": "Test Level 1",
    "description": "A simple level with numbers and operators",
    "width": 18,
    "height": 18 
  },
  "map": [
    ["W", "W", "W", "W", "W", "W", "W", "W", "W", "W", "W", "W", "W", "W", "W", "W", "W", "W"],
    ["W", ".", ".", "W", ".", ".", ".", "W", ".", ".", ".", ".", ".", ".", ".", ".", ".", "W"],
    ["W", ".", ".", ".", ".", ".", ".", "W", ".", ".", ".", ".", ".", ".", ".", ".", ".", "W"],
    ["W", ".", ".", ".", ".", ".", ".", "W", ".", ".", ".", ".", ".", ".", ".", ".", ".", "W"],
    ["W", "W", "W", ".", "P", ".", ".", "W", ".", ".", ".", ".", ".", ".", ".", ".", ".", "W"],
    ["W", ".", ".", ".", ".", ".", ".", "W", ".", ".", ".", ".", ".", ".", ".", ".", ".", "W"],
    ["W", ".", "+", ".", ".", "-", ".", "W", ".", "*", ".", ".", ".", "/", ".", ".", ".", "W"],
    ["W", ".", ".", ".", ".", ".", ".", "W", ".", ".", ".", ".", ".", ".", ".", ".", ".", "W"],
    ["W", ".", ".", ".", ".", ".", ".", "W", ".", ".", ".", ".", ".", ".", ".", ".", ".", "W"],
    ["W", ".", ".", ".", ".", ".", ".", ".", ".", ".", ".", ".", ".", ".", ".", ".", ".", "W"],
    ["W", ".", ".", ".", ".", ".", ".", ".", ".", ".", ".", ".", ".", ".", ".", ".", ".", "W"],
    ["W", ".", ".", ".", ".", ".", ".", ".", ".", ".", ".", ".", ".", ".", ".", ".", ".", "W"],
    ["W", ".", ".", ".", ".", ".", ".", ".", ".", ".", ".", ".", ".", ".", ".", ".", ".", "W"],
    ["W", ".", ".", ".", ".", ".", ".", ".", ".", ".", ".", ".", ".", ".", ".", ".", ".", "W"],
    ["W", ".", ".", ".", ".", ".", ".", ".", ".", ".", ".", ".", ".", ".", ".", ".", ".", "W"],
    ["W", ".", ".", ".", ".", ".", ".", ".", ".", ".", ".", ".", ".", ".", ".", ".", ".", "W"],
    ["W", ".", ".", ".", ".", ".", ".", ".", ".", ".", ".", ".", ".", ".", ".", ".", ".", "W"],
    ["W", "W", "W", "W", "W", "W", "W", "W", "W", "W", "W", "W", "W", "W", "W", "W", "W", "W"]
  ],
  "numbers": [
    {"x": 1, "y": 10, "value": 10},
    {"x": 3, "y": 10, "value": 15},
    {"x": 5, "y": 10, "value": 11},
    {"x": 7, "y": 10, "value": 999}
  ],
  "targets": [
    {"x": 3, "y": 2, "requiredValue": 42}
  ]
}
